ID	Key
string	string
Id	Key
Talent_TreasureHunt	海上宝藏
Talent_TechFirst	科技为先
Talent_AdvanceBoat	高级船只
Talent_HardWork	努力工作
Talent_Bargon	讨价还价
Talent_ShipMaster	造船达人
Talent_VoidBoat	无中生有
Talent_SeaConqueror	海上霸主
Talent_FireUp	火力全开
Talent_GiveMeMore	更多宝藏
Talent_MeetSeaLord	海怪之王
Talent_LandLord	我是地主
Talent_Discovery	发现遗迹
Talent_NewEra	新星纪元
Talent_Des_TreasureHunt	航行中有几率发现高级宝箱
Talent_Des_TechFirst	在线可持续产生TP点数
Talent_Des_AdvanceBoat	船只收入提升
Talent_Des_HardWork	离线收入提升
Talent_Des_Bargon	船只购买价格降低
Talent_Des_ShipMaster	合成船只能获得更多经验
Talent_Des_VoidBoat	合成更高等级船只有概率不消耗船只
Talent_Des_SeaConqueror	所有收益提升
Talent_Des_FireUp	对海怪伤害增加
Talent_Des_GiveMeMore	海怪掉落更多宝藏
Talent_Des_MeetSeaLord	有概率刷出海怪之王
Talent_Des_LandLord	解锁岛屿的成本降低
Talent_Des_Discovery	解锁岛屿会给予更多TP点数
Talent_Des_NewEra	开启新时代会获得更多TP点数
